##############
# P          #
#  O    XXX  #
#            #
#####   ######
#            #
###        ###
#O          O#
##############
